NO ./texture/cabibara.xpm
SO ./texture/cabibara.xpm
WE ./texture/cabibara.xpm
EA ./texture/cabibara.xpm

F 138,138,138
C 56,182,255

       1111111111
       1000000001
       1000000001
       1111001111
11111111000000001
10000S00011111111
1000000001
1000000001111111111
1111111100000000001
        11111111111
